#####################
#                   #
####### #############
#    @              #
# ########  #########
#     #         #   #
#     ###########   #
#                   #
#####################